Año,Trimestre,Provincia,Banda ancha fija,Dial up,Total
2022,3,Buenos Aires,4715469,6199,4721668
2022,3,Capital Federal,1545534,2145,1547679
2022,3,Catamarca,70292,10,70302
2022,3,Chaco,144141,50,144191
2022,3,Chubut,164874,9040,173914
2022,3,Córdoba,1038600,680,1039280
2022,3,Corrientes,144842,40,144882
2022,3,Entre Ríos,268937,220,269157
2022,3,Formosa,68537,10,68547
2022,3,Jujuy,118823,0,118823
2022,3,La Pampa,115921,1710,117631
2022,3,La Rioja,86860,40,86900
2022,3,Mendoza,288746,7770,296516
2022,3,Misiones,182157,0,182157
2022,3,Neuquén,162693,4680,167373
2022,3,Río Negro,160010,5480,165490
2022,3,Salta,204536,50,204586
2022,3,San Juan,103118,2810,105928
2022,3,San Luis,121888,1820,123708
2022,3,Santa Cruz,49312,1980,51292
2022,3,Santa Fe,887700,1100,888800
2022,3,Santiago Del Estero,119030,20,119050
2022,3,Tierra Del Fuego,53584,3120,56704
2022,3,Tucumán,263087,300,263387
2022,2,Buenos Aires,4660984,6199,4667183
2022,2,Capital Federal,1534626,2145,1536771
2022,2,Catamarca,67007,10,67017
2022,2,Chaco,143559,50,143609
2022,2,Chubut,161901,9040,170941
2022,2,Córdoba,1026367,680,1027047
2022,2,Corrientes,144993,40,145033
2022,2,Entre Ríos,269330,220,269550
2022,2,Formosa,67881,0,67881
2022,2,Jujuy,115314,0,115314
2022,2,La Pampa,111356,1710,113066
2022,2,La Rioja,86026,40,86066
2022,2,Mendoza,278785,7770,286555
2022,2,Misiones,178813,0,178813
2022,2,Neuquén,161500,4680,166180
2022,2,Río Negro,159216,5480,164696
2022,2,Salta,203172,50,203222
2022,2,San Juan,100126,2810,102936
2022,2,San Luis,121559,1820,123379
2022,2,Santa Cruz,48987,1980,50967
2022,2,Santa Fe,878749,1100,879849
2022,2,Santiago Del Estero,118042,20,118062
2022,2,Tierra Del Fuego,53458,3120,56578
2022,2,Tucumán,254497,300,254797
2022,1,Buenos Aires,4549131,6293,4555424
2022,1,Capital Federal,1415378,2163,1417541
2022,1,Catamarca,62377,10,62387
2022,1,Chaco,144114,50,144164
2022,1,Chubut,170701,9270,179971
2022,1,Córdoba,1003729,740,1004469
2022,1,Corrientes,142574,40,142614
2022,1,Entre Ríos,267904,220,268124
2022,1,Formosa,54548,0,54548
2022,1,Jujuy,116509,0,116509
2022,1,La Pampa,109560,1720,111280
2022,1,La Rioja,84299,40,84339
2022,1,Mendoza,274399,7860,282259
2022,1,Misiones,171508,0,171508
2022,1,Neuquén,149208,4710,153918
2022,1,Río Negro,156821,5530,162351
2022,1,Salta,197510,50,197560
2022,1,San Juan,87888,2900,90788
2022,1,San Luis,119659,1850,121509
2022,1,Santa Cruz,48898,2040,50938
2022,1,Santa Fe,870364,1150,871514
2022,1,Santiago Del Estero,116459,20,116479
2022,1,Tierra Del Fuego,52298,3130,55428
2022,1,Tucumán,245554,300,245854
2021,4,Buenos Aires,4502772,6385,4509157
2021,4,Capital Federal,1409935,2184,1412119
2021,4,Catamarca,59089,10,59099
2021,4,Chaco,143740,50,143790
2021,4,Chubut,159364,9440,168804
2021,4,Córdoba,986693,770,987463
2021,4,Corrientes,135908,40,135948
2021,4,Entre Ríos,265024,220,265244
2021,4,Formosa,53663,0,53663
2021,4,Jujuy,113915,0,113915
2021,4,La Pampa,106834,1730,108564
2021,4,La Rioja,83124,40,83164
2021,4,Mendoza,266783,8040,274823
2021,4,Misiones,171132,0,171132
2021,4,Neuquén,146989,4770,151759
2021,4,Río Negro,153189,5640,158829
2021,4,Salta,199399,60,199459
2021,4,San Juan,79667,2910,82577
2021,4,San Luis,118662,1870,120532
2021,4,Santa Cruz,48276,2100,50376
2021,4,Santa Fe,866265,1760,868025
2021,4,Santiago Del Estero,115859,20,115879
2021,4,Tierra Del Fuego,52042,3150,55192
2021,4,Tucumán,238609,300,238909
2021,3,Buenos Aires,4246425,5184,4251609
2021,3,Capital Federal,1411797,1608,1413405
2021,3,Catamarca,56253,10,56263
2021,3,Chaco,139868,30,139898
2021,3,Chubut,155266,8000,163266
2021,3,Córdoba,946726,620,947346
2021,3,Corrientes,133816,30,133846
2021,3,Entre Ríos,260360,150,260510
2021,3,Formosa,52795,0,52795
2021,3,Jujuy,111158,0,111158
2021,3,La Pampa,100371,1160,101531
2021,3,La Rioja,82157,30,82187
2021,3,Mendoza,255320,6190,261510
2021,3,Misiones,158528,0,158528
2021,3,Neuquén,139436,3730,143166
2021,3,Río Negro,144084,5010,149094
2021,3,Salta,195831,20,195851
2021,3,San Juan,79227,2560,81787
2021,3,San Luis,117716,1480,119196
2021,3,Santa Cruz,48779,1970,50749
2021,3,Santa Fe,841433,1510,842943
2021,3,Santiago Del Estero,115457,10,115467
2021,3,Tierra Del Fuego,49934,2890,52824
2021,3,Tucumán,232447,250,232697
2021,2,Buenos Aires,4127167,5184,4132351
2021,2,Capital Federal,1398747,1608,1400355
2021,2,Catamarca,55743,10,55753
2021,2,Chaco,140726,30,140756
2021,2,Chubut,138412,8250,146662
2021,2,Córdoba,930818,620,931438
2021,2,Corrientes,129498,30,129528
2021,2,Entre Ríos,257617,150,257767
2021,2,Formosa,51551,0,51551
2021,2,Jujuy,111848,0,111848
2021,2,La Pampa,97551,1160,98711
2021,2,La Rioja,81599,30,81629
2021,2,Mendoza,229052,6190,235242
2021,2,Misiones,156176,0,156176
2021,2,Neuquén,137877,3730,141607
2021,2,Río Negro,143583,5010,148593
2021,2,Salta,191637,20,191657
2021,2,San Juan,78677,2560,81237
2021,2,San Luis,122670,1480,124150
2021,2,Santa Cruz,48785,1970,50755
2021,2,Santa Fe,840449,1510,841959
2021,2,Santiago Del Estero,114089,10,114099
2021,2,Tierra Del Fuego,35404,2890,38294
2021,2,Tucumán,233026,250,233276
2021,1,Buenos Aires,4054936,5066,4060002
2021,1,Capital Federal,1378283,139,1378422
2021,1,Catamarca,51967,10,51977
2021,1,Chaco,139767,30,139797
2021,1,Chubut,131515,8250,139765
2021,1,Córdoba,910826,550,911376
2021,1,Corrientes,126622,30,126652
2021,1,Entre Ríos,251950,130,252080
2021,1,Formosa,50686,0,50686
2021,1,Jujuy,110456,0,110456
2021,1,La Pampa,96989,1160,98149
2021,1,La Rioja,52625,30,52655
2021,1,Mendoza,218308,6150,224458
2021,1,Misiones,149387,0,149387
2021,1,Neuquén,132862,3730,136592
2021,1,Río Negro,140667,5010,145677
2021,1,Salta,187572,20,187592
2021,1,San Juan,78011,2560,80571
2021,1,San Luis,119006,1480,120486
2021,1,Santa Cruz,45868,1970,47838
2021,1,Santa Fe,825990,1370,827360
2021,1,Santiago Del Estero,111640,10,111650
2021,1,Tierra Del Fuego,40133,2890,43023
2021,1,Tucumán,231890,220,232110
2020,4,Buenos Aires,4028195,5066,4033261
2020,4,Capital Federal,1378140,139,1378279
2020,4,Catamarca,52395,10,52405
2020,4,Chaco,139088,30,139118
2020,4,Chubut,129749,8250,137999
2020,4,Córdoba,902646,550,903196
2020,4,Corrientes,125656,30,125686
2020,4,Entre Ríos,247368,130,247498
2020,4,Formosa,50206,0,50206
2020,4,Jujuy,105851,0,105851
2020,4,La Pampa,96779,1160,97939
2020,4,La Rioja,52775,30,52805
2020,4,Mendoza,214838,6150,220988
2020,4,Misiones,147161,0,147161
2020,4,Neuquén,132762,3730,136492
2020,4,Río Negro,140709,5010,145719
2020,4,Salta,187388,20,187408
2020,4,San Juan,72340,2560,74900
2020,4,San Luis,119287,1480,120767
2020,4,Santa Cruz,40477,1970,42447
2020,4,Santa Fe,820676,1370,822046
2020,4,Santiago Del Estero,106668,10,106678
2020,4,Tierra Del Fuego,39325,2890,42215
2020,4,Tucumán,231067,220,231287
2020,3,Buenos Aires,3932211,5066,3937277
2020,3,Capital Federal,1371285,139,1371424
2020,3,Catamarca,49903,10,49913
2020,3,Chaco,133951,30,133981
2020,3,Chubut,129202,8250,137452
2020,3,Córdoba,867417,550,867967
2020,3,Corrientes,123388,30,123418
2020,3,Entre Ríos,241482,130,241612
2020,3,Formosa,49209,0,49209
2020,3,Jujuy,106728,0,106728
2020,3,La Pampa,93619,1160,94779
2020,3,La Rioja,52613,30,52643
2020,3,Mendoza,207173,6150,213323
2020,3,Misiones,143186,0,143186
2020,3,Neuquén,128862,3730,132592
2020,3,Río Negro,130966,5010,135976
2020,3,Salta,180844,20,180864
2020,3,San Juan,77071,2560,79631
2020,3,San Luis,116417,1480,117897
2020,3,Santa Cruz,39084,1970,41054
2020,3,Santa Fe,802861,1370,804231
2020,3,Santiago Del Estero,105491,10,105501
2020,3,Tierra Del Fuego,39366,2890,42256
2020,3,Tucumán,223854,220,224074
2020,2,Buenos Aires,3772480,5066,3777546
2020,2,Capital Federal,1356431,139,1356570
2020,2,Catamarca,47975,10,47985
2020,2,Chaco,128129,30,128159
2020,2,Chubut,107831,8250,116081
2020,2,Córdoba,836413,550,836963
2020,2,Corrientes,118863,30,118893
2020,2,Entre Ríos,234100,130,234230
2020,2,Formosa,47932,0,47932
2020,2,Jujuy,94316,0,94316
2020,2,La Pampa,89693,1160,90853
2020,2,La Rioja,52152,30,52182
2020,2,Mendoza,200569,6150,206719
2020,2,Misiones,140340,0,140340
2020,2,Neuquén,125799,3730,129529
2020,2,Río Negro,128985,5010,133995
2020,2,Salta,177760,20,177780
2020,2,San Juan,69521,2560,72081
2020,2,San Luis,113804,1480,115284
2020,2,Santa Cruz,38672,1970,40642
2020,2,Santa Fe,777795,1370,779165
2020,2,Santiago Del Estero,105446,10,105456
2020,2,Tierra Del Fuego,38900,2890,41790
2020,2,Tucumán,217134,220,217354
2020,1,Buenos Aires,3702985,5066,3708051
2020,1,Capital Federal,1352104,139,1352243
2020,1,Catamarca,39634,10,39644
2020,1,Chaco,120274,30,120304
2020,1,Chubut,95938,8000,103938
2020,1,Córdoba,811044,550,811594
2020,1,Corrientes,113967,30,113997
2020,1,Entre Ríos,231833,130,231963
2020,1,Formosa,46434,0,46434
2020,1,Jujuy,91665,0,91665
2020,1,La Pampa,89110,1160,90270
2020,1,La Rioja,48337,30,48367
2020,1,Mendoza,182837,6150,188987
2020,1,Misiones,133552,0,133552
2020,1,Neuquén,121354,3730,125084
2020,1,Río Negro,125699,5010,130709
2020,1,Salta,170379,20,170399
2020,1,San Juan,63975,2560,66535
2020,1,San Luis,110404,1480,111884
2020,1,Santa Cruz,38625,1970,40595
2020,1,Santa Fe,770981,1370,772351
2020,1,Santiago Del Estero,102754,10,102764
2020,1,Tierra Del Fuego,38505,2890,41395
2020,1,Tucumán,200045,220,200265
2019,4,Buenos Aires,3681120,5134,3686254
2019,4,Capital Federal,1356695,141,1356836
2019,4,Catamarca,38310,10,38320
2019,4,Chaco,117900,30,117930
2019,4,Chubut,95292,8100,103392
2019,4,Córdoba,806633,550,807183
2019,4,Corrientes,113831,30,113861
2019,4,Entre Ríos,239017,130,239147
2019,4,Formosa,46711,0,46711
2019,4,Jujuy,88881,0,88881
2019,4,La Pampa,90280,1190,91470
2019,4,La Rioja,48999,30,49029
2019,4,Mendoza,185157,6230,191387
2019,4,Misiones,135813,0,135813
2019,4,Neuquén,116069,3760,119829
2019,4,Río Negro,126636,5040,131676
2019,4,Salta,172443,20,172463
2019,4,San Juan,64715,2590,67305
2019,4,San Luis,108053,1480,109533
2019,4,Santa Cruz,39170,2000,41170
2019,4,Santa Fe,769019,1500,770519
2019,4,Santiago Del Estero,103587,10,103597
2019,4,Tierra Del Fuego,40101,2910,43011
2019,4,Tucumán,198621,230,198851
2019,3,Buenos Aires,3950114,10119,3960233
2019,3,Capital Federal,1437734,3477,1441211
2019,3,Catamarca,32391,90,32481
2019,3,Chaco,114438,130,114568
2019,3,Chubut,87481,1524,89005
2019,3,Córdoba,782946,1070,784016
2019,3,Corrientes,112749,100,112849
2019,3,Entre Ríos,238057,450,238507
2019,3,Formosa,46066,0,46066
2019,3,Jujuy,86575,10,86585
2019,3,La Pampa,90559,2690,93249
2019,3,La Rioja,49659,180,49839
2019,3,Mendoza,223015,1322,224337
2019,3,Misiones,133883,0,133883
2019,3,Neuquén,123435,1986,125421
2019,3,Río Negro,143391,9040,152431
2019,3,Salta,151834,10,151844
2019,3,San Juan,72535,5630,78165
2019,3,San Luis,122409,2910,125319
2019,3,Santa Cruz,37642,3280,40922
2019,3,Santa Fe,760706,2280,762986
2019,3,Santiago Del Estero,133130,20,133150
2019,3,Tierra Del Fuego,48043,5440,53483
2019,3,Tucumán,164099,320,164419
2019,2,Buenos Aires,3845594,10104,3855698
2019,2,Capital Federal,1412177,3443,1415620
2019,2,Catamarca,33626,90,33716
2019,2,Chaco,108721,130,108851
2019,2,Chubut,86038,1518,87556
2019,2,Córdoba,775023,1050,776073
2019,2,Corrientes,111539,100,111639
2019,2,Entre Ríos,235780,440,236220
2019,2,Formosa,46438,0,46438
2019,2,Jujuy,86706,10,86716
2019,2,La Pampa,89937,2680,92617
2019,2,La Rioja,50283,180,50463
2019,2,Mendoza,222535,1322,223857
2019,2,Misiones,132878,0,132878
2019,2,Neuquén,120954,1999,122953
2019,2,Río Negro,137632,9150,146782
2019,2,Salta,142567,10,142577
2019,2,San Juan,69461,5640,75101
2019,2,San Luis,117094,2910,120004
2019,2,Santa Cruz,30225,3250,33475
2019,2,Santa Fe,743258,2260,745518
2019,2,Santiago Del Estero,126752,20,126772
2019,2,Tierra Del Fuego,46910,5440,52350
2019,2,Tucumán,166299,320,166619
2019,1,Buenos Aires,3736563,10104,3746667
2019,1,Capital Federal,1396157,3443,1399600
2019,1,Catamarca,33613,90,33703
2019,1,Chaco,103664,130,103794
2019,1,Chubut,78260,1518,79778
2019,1,Córdoba,744010,1050,745060
2019,1,Corrientes,102477,100,102577
2019,1,Entre Ríos,232403,440,232843
2019,1,Formosa,45211,0,45211
2019,1,Jujuy,90146,10,90156
2019,1,La Pampa,88892,2680,91572
2019,1,La Rioja,51638,180,51818
2019,1,Mendoza,204976,1322,206298
2019,1,Misiones,122720,0,122720
2019,1,Neuquén,112321,2056,114377
2019,1,Río Negro,120173,9150,129323
2019,1,Salta,136019,10,136029
2019,1,San Juan,61881,5640,67521
2019,1,San Luis,96044,2910,98954
2019,1,Santa Cruz,24580,3250,27830
2019,1,Santa Fe,736851,2270,739121
2019,1,Santiago Del Estero,89851,20,89871
2019,1,Tierra Del Fuego,45903,5440,51343
2019,1,Tucumán,171970,320,172290
2018,4,Buenos Aires,3626502,10104,3636606
2018,4,Capital Federal,1385577,3443,1389020
2018,4,Catamarca,33574,90,33664
2018,4,Chaco,103257,130,103387
2018,4,Chubut,77204,1518,78722
2018,4,Córdoba,737234,1050,738284
2018,4,Corrientes,100591,100,100691
2018,4,Entre Ríos,222003,440,222443
2018,4,Formosa,45204,0,45204
2018,4,Jujuy,90132,10,90142
2018,4,La Pampa,85368,2680,88048
2018,4,La Rioja,51633,180,51813
2018,4,Mendoza,204982,1322,206304
2018,4,Misiones,116273,0,116273
2018,4,Neuquén,112309,2056,114365
2018,4,Río Negro,115922,9150,125072
2018,4,Salta,134577,10,134587
2018,4,San Juan,61834,5640,67474
2018,4,San Luis,96040,2910,98950
2018,4,Santa Cruz,24443,3250,27693
2018,4,Santa Fe,720161,2290,722451
2018,4,Santiago Del Estero,89333,20,89353
2018,4,Tierra Del Fuego,45716,5440,51156
2018,4,Tucumán,171972,320,172292
2018,3,Buenos Aires,3599714,10563,3610277
2018,3,Capital Federal,1385804,6686,1392490
2018,3,Catamarca,34215,110,34325
2018,3,Chaco,102021,120,102141
2018,3,Chubut,101310,2426,103736
2018,3,Córdoba,725764,940,726704
2018,3,Corrientes,99445,110,99555
2018,3,Entre Ríos,204560,480,205040
2018,3,Formosa,44865,0,44865
2018,3,Jujuy,44934,10,44944
2018,3,La Pampa,83180,2440,85620
2018,3,La Rioja,51855,170,52025
2018,3,Mendoza,205545,1484,207029
2018,3,Misiones,108042,0,108042
2018,3,Neuquén,114713,2005,116718
2018,3,Río Negro,112433,1059,113492
2018,3,Salta,132882,10,132892
2018,3,San Juan,63823,6580,70403
2018,3,San Luis,74121,3000,77121
2018,3,Santa Cruz,33565,4340,37905
2018,3,Santa Fe,694883,2170,697053
2018,3,Santiago Del Estero,86358,20,86378
2018,3,Tierra Del Fuego,45056,5080,50136
2018,3,Tucumán,171135,310,171445
2018,2,Buenos Aires,3490134,10565,3500699
2018,2,Capital Federal,1362498,6688,1369186
2018,2,Catamarca,34078,110,34188
2018,2,Chaco,98509,120,98629
2018,2,Chubut,98137,2427,100564
2018,2,Córdoba,712979,940,713919
2018,2,Corrientes,97946,110,98056
2018,2,Entre Ríos,199937,480,200417
2018,2,Formosa,44554,0,44554
2018,2,Jujuy,45132,10,45142
2018,2,La Pampa,82177,2440,84617
2018,2,La Rioja,51931,170,52101
2018,2,Mendoza,199468,1484,200952
2018,2,Misiones,106147,0,106147
2018,2,Neuquén,113842,2006,115848
2018,2,Río Negro,111176,1059,112235
2018,2,Salta,134166,10,134176
2018,2,San Juan,63443,6580,70023
2018,2,San Luis,21168,3000,24168
2018,2,Santa Cruz,33970,4350,38320
2018,2,Santa Fe,684243,3090,687333
2018,2,Santiago Del Estero,83773,20,83793
2018,2,Tierra Del Fuego,44199,5080,49279
2018,2,Tucumán,169926,310,170236
2018,1,Buenos Aires,3464882,10564,3475446
2018,1,Capital Federal,1359882,6688,1366570
2018,1,Catamarca,33934,110,34044
2018,1,Chaco,96925,120,97045
2018,1,Chubut,95532,2427,97959
2018,1,Córdoba,713825,1010,714835
2018,1,Corrientes,94406,110,94516
2018,1,Entre Ríos,197346,480,197826
2018,1,Formosa,32328,0,32328
2018,1,Jujuy,44405,10,44415
2018,1,La Pampa,82668,3960,86628
2018,1,La Rioja,52228,170,52398
2018,1,Mendoza,199463,1484,200947
2018,1,Misiones,103580,0,103580
2018,1,Neuquén,115897,2006,117903
2018,1,Río Negro,110057,1062,111119
2018,1,Salta,133182,10,133192
2018,1,San Juan,62610,6580,69190
2018,1,San Luis,21096,3000,24096
2018,1,Santa Cruz,33970,4350,38320
2018,1,Santa Fe,679717,3090,682807
2018,1,Santiago Del Estero,82916,20,82936
2018,1,Tierra Del Fuego,31106,5080,36186
2018,1,Tucumán,168026,310,168336
2017,4,Buenos Aires,3171206,1069,3172275
2017,4,Capital Federal,1575418,6906,1582324
2017,4,Catamarca,29548,100,29648
2017,4,Chaco,96603,120,96723
2017,4,Chubut,91012,2428,93440
2017,4,Córdoba,709874,1050,710924
2017,4,Corrientes,93760,110,93870
2017,4,Entre Ríos,193654,490,194144
2017,4,Formosa,32056,0,32056
2017,4,Jujuy,43551,10,43561
2017,4,La Pampa,81675,3960,85635
2017,4,La Rioja,52177,170,52347
2017,4,Mendoza,178661,149,178810
2017,4,Misiones,103895,0,103895
2017,4,Neuquén,114965,2006,116971
2017,4,Río Negro,108702,1062,109764
2017,4,Salta,132811,10,132821
2017,4,San Juan,57965,6590,64555
2017,4,San Luis,14604,3000,17604
2017,4,Santa Cruz,29018,4340,33358
2017,4,Santa Fe,672137,3230,675367
2017,4,Santiago Del Estero,68842,20,68862
2017,4,Tierra Del Fuego,28346,5080,33426
2017,4,Tucumán,162298,340,162638
2017,3,Buenos Aires,3046758,11202,3057960
2017,3,Capital Federal,1563289,707,1563996
2017,3,Catamarca,33467,110,33577
2017,3,Chaco,93747,120,93867
2017,3,Chubut,81067,2477,83544
2017,3,Córdoba,696536,1080,697616
2017,3,Corrientes,92536,120,92656
2017,3,Entre Ríos,185414,500,185914
2017,3,Formosa,32105,0,32105
2017,3,Jujuy,43241,10,43251
2017,3,La Pampa,79280,4100,83380
2017,3,La Rioja,51896,170,52066
2017,3,Mendoza,190958,1533,192491
2017,3,Misiones,100476,0,100476
2017,3,Neuquén,113755,2029,115784
2017,3,Río Negro,106393,1103,107496
2017,3,Salta,132517,10,132527
2017,3,San Juan,61789,6600,68389
2017,3,San Luis,21408,3110,24518
2017,3,Santa Cruz,33222,4680,37902
2017,3,Santa Fe,662086,2560,664646
2017,3,Santiago Del Estero,82792,20,82812
2017,3,Tierra Del Fuego,30883,5830,36713
2017,3,Tucumán,160979,330,161309
2017,2,Buenos Aires,3067430,11201,3078631
2017,2,Capital Federal,1592175,8016,1600191
2017,2,Catamarca,26692,130,26822
2017,2,Chaco,90597,140,90737
2017,2,Chubut,62245,173,62418
2017,2,Córdoba,657505,1330,658835
2017,2,Corrientes,90085,120,90205
2017,2,Entre Ríos,182675,570,183245
2017,2,Formosa,29956,0,29956
2017,2,Jujuy,42656,10,42666
2017,2,La Pampa,72573,4490,77063
2017,2,La Rioja,16271,180,16451
2017,2,Mendoza,169302,1451,170753
2017,2,Misiones,99794,0,99794
2017,2,Neuquén,115321,2112,117433
2017,2,Río Negro,100621,9980,110601
2017,2,Salta,108540,10,108550
2017,2,San Juan,51261,6200,57461
2017,2,San Luis,12992,3150,16142
2017,2,Santa Cruz,26019,3690,29709
2017,2,Santa Fe,566918,3620,570538
2017,2,Santiago Del Estero,33194,20,33214
2017,2,Tierra Del Fuego,31938,6190,38128
2017,2,Tucumán,154374,370,154744
2017,1,Buenos Aires,3178174,11202,3189376
2017,1,Capital Federal,1391030,8016,1399046
2017,1,Catamarca,26304,130,26434
2017,1,Chaco,89036,140,89176
2017,1,Chubut,62166,173,62339
2017,1,Córdoba,641066,1330,642396
2017,1,Corrientes,88596,120,88716
2017,1,Entre Ríos,180296,570,180866
2017,1,Formosa,29705,0,29705
2017,1,Jujuy,43202,10,43212
2017,1,La Pampa,71458,4550,76008
2017,1,La Rioja,16207,180,16387
2017,1,Mendoza,169282,1451,170733
2017,1,Misiones,97619,0,97619
2017,1,Neuquén,113227,2112,115339
2017,1,Río Negro,100288,10,100298
2017,1,Salta,107632,10,107642
2017,1,San Juan,51253,6200,57453
2017,1,San Luis,12992,3150,16142
2017,1,Santa Cruz,26116,3700,29816
2017,1,Santa Fe,562520,3620,566140
2017,1,Santiago Del Estero,34473,20,34493
2017,1,Tierra Del Fuego,31938,6190,38128
2017,1,Tucumán,152734,370,153104
2016,4,Buenos Aires,3131499,11202,3142701
2016,4,Capital Federal,1393443,8016,1401459
2016,4,Catamarca,27021,130,27151
2016,4,Chaco,88833,140,88973
2016,4,Chubut,62035,173,62208
2016,4,Córdoba,636422,1330,637752
2016,4,Corrientes,88084,120,88204
2016,4,Entre Ríos,180188,570,180758
2016,4,Formosa,29513,0,29513
2016,4,Jujuy,42624,10,42634
2016,4,La Pampa,71368,4600,75968
2016,4,La Rioja,16298,180,16478
2016,4,Mendoza,169274,1451,170725
2016,4,Misiones,97390,0,97390
2016,4,Neuquén,111723,2112,113835
2016,4,Río Negro,100020,10,100030
2016,4,Salta,106934,10,106944
2016,4,San Juan,51301,6200,57501
2016,4,San Luis,12992,3150,16142
2016,4,Santa Cruz,26094,3700,29794
2016,4,Santa Fe,561470,3620,565090
2016,4,Santiago Del Estero,35049,20,35069
2016,4,Tierra Del Fuego,31938,6190,38128
2016,4,Tucumán,151615,370,151985
2016,3,Buenos Aires,3075387,11205,3086592
2016,3,Capital Federal,1395053,8051,1403104
2016,3,Catamarca,26957,130,27087
2016,3,Chaco,89216,140,89356
2016,3,Chubut,62222,173,62395
2016,3,Córdoba,642458,1330,643788
2016,3,Corrientes,88328,120,88448
2016,3,Entre Ríos,181092,570,181662
2016,3,Formosa,27716,0,27716
2016,3,Jujuy,42537,10,42547
2016,3,La Pampa,69903,4610,74513
2016,3,La Rioja,16912,180,17092
2016,3,Mendoza,169174,145,169319
2016,3,Misiones,97997,0,97997
2016,3,Neuquén,110491,2112,112603
2016,3,Río Negro,100024,1002,101026
2016,3,Salta,107790,10,107800
2016,3,San Juan,51348,6200,57548
2016,3,San Luis,12978,3150,16128
2016,3,Santa Cruz,25886,3710,29596
2016,3,Santa Fe,566625,3860,570485
2016,3,Santiago Del Estero,35658,20,35678
2016,3,Tierra Del Fuego,31306,6190,37496
2016,3,Tucumán,151282,370,151652
2016,2,Buenos Aires,3032776,12515,3045291
2016,2,Capital Federal,1384824,976,1385800
2016,2,Catamarca,26543,130,26673
2016,2,Chaco,88235,160,88395
2016,2,Chubut,62116,174,62290
2016,2,Córdoba,634680,2340,637020
2016,2,Corrientes,86932,240,87172
2016,2,Entre Ríos,178194,1790,179984
2016,2,Formosa,28801,10,28811
2016,2,Jujuy,41187,20,41207
2016,2,La Pampa,68403,4850,73253
2016,2,La Rioja,16718,180,16898
2016,2,Mendoza,169274,155,169429
2016,2,Misiones,95808,70,95878
2016,2,Neuquén,108224,2291,110515
2016,2,Río Negro,99631,1073,100704
2016,2,Salta,104929,30,104959
2016,2,San Juan,51392,6210,57602
2016,2,San Luis,12939,3170,16109
2016,2,Santa Cruz,25797,3560,29357
2016,2,Santa Fe,563867,6070,569937
2016,2,Santiago Del Estero,36958,30,36988
2016,2,Tierra Del Fuego,30740,6190,36930
2016,2,Tucumán,148636,410,149046
2016,1,Buenos Aires,2929903,12612,2942515
2016,1,Capital Federal,1328079,9817,1337896
2016,1,Catamarca,26376,130,26506
2016,1,Chaco,86635,160,86795
2016,1,Chubut,62060,174,62234
2016,1,Córdoba,609692,2340,612032
2016,1,Corrientes,85510,260,85770
2016,1,Entre Ríos,174634,1790,176424
2016,1,Formosa,28313,10,28323
2016,1,Jujuy,40287,20,40307
2016,1,La Pampa,65442,4870,70312
2016,1,La Rioja,16673,180,16853
2016,1,Mendoza,169257,1553,170810
2016,1,Misiones,92951,70,93021
2016,1,Neuquén,101969,2292,104261
2016,1,Río Negro,98745,1077,99822
2016,1,Salta,102423,30,102453
2016,1,San Juan,51373,6210,57583
2016,1,San Luis,12915,3170,16085
2016,1,Santa Cruz,25931,3560,29491
2016,1,Santa Fe,551378,6180,557558
2016,1,Santiago Del Estero,37695,30,37725
2016,1,Tierra Del Fuego,29867,6190,36057
2016,1,Tucumán,146596,410,147006
2015,4,Buenos Aires,2946743,12642,2959385
2015,4,Capital Federal,1360381,9845,1370226
2015,4,Catamarca,26459,130,26589
2015,4,Chaco,86537,160,86697
2015,4,Chubut,62279,174,62453
2015,4,Córdoba,625835,2350,628185
2015,4,Corrientes,85409,260,85669
2015,4,Entre Ríos,173957,1800,175757
2015,4,Formosa,28088,10,28098
2015,4,Jujuy,39922,20,39942
2015,4,La Pampa,66054,3120,69174
2015,4,La Rioja,16914,180,17094
2015,4,Mendoza,169251,1556,170807
2015,4,Misiones,92846,70,92916
2015,4,Neuquén,105122,2294,107416
2015,4,Río Negro,98655,1067,99722
2015,4,Salta,101917,30,101947
2015,4,San Juan,51408,6210,57618
2015,4,San Luis,12901,3170,16071
2015,4,Santa Cruz,26047,3560,29607
2015,4,Santa Fe,561045,6270,567315
2015,4,Santiago Del Estero,39132,30,39162
2015,4,Tierra Del Fuego,29334,6190,35524
2015,4,Tucumán,146053,420,146473
2015,3,Buenos Aires,2916070,12695,2928765
2015,3,Capital Federal,1362193,9875,1372068
2015,3,Catamarca,26080,130,26210
2015,3,Chaco,85354,160,85514
2015,3,Chubut,62143,174,62317
2015,3,Córdoba,622761,2370,625131
2015,3,Corrientes,84931,280,85211
2015,3,Entre Ríos,172252,1820,174072
2015,3,Formosa,27751,10,27761
2015,3,Jujuy,39548,20,39568
2015,3,La Pampa,64976,4950,69926
2015,3,La Rioja,16753,180,16933
2015,3,Mendoza,169261,1562,170823
2015,3,Misiones,91615,70,91685
2015,3,Neuquén,98376,224,98600
2015,3,Río Negro,98529,1085,99614
2015,3,Salta,100570,30,100600
2015,3,San Juan,51409,6210,57619
2015,3,San Luis,12902,3170,16072
2015,3,Santa Cruz,25912,3590,29502
2015,3,Santa Fe,556097,6410,562507
2015,3,Santiago Del Estero,39394,30,39424
2015,3,Tierra Del Fuego,33118,6190,39308
2015,3,Tucumán,144272,420,144692
2015,2,Buenos Aires,2871079,12711,2883790
2015,2,Capital Federal,1336391,9893,1346284
2015,2,Catamarca,25666,130,25796
2015,2,Chaco,83832,160,83992
2015,2,Chubut,61745,174,61919
2015,2,Córdoba,609510,2360,611870
2015,2,Corrientes,83288,280,83568
2015,2,Entre Ríos,169309,1830,171139
2015,2,Formosa,27013,370,27383
2015,2,Jujuy,37720,20,37740
2015,2,La Pampa,63552,5000,68552
2015,2,La Rioja,16491,180,16671
2015,2,Mendoza,169259,1564,170823
2015,2,Misiones,88512,70,88582
2015,2,Neuquén,95644,2241,97885
2015,2,Río Negro,97640,1087,98727
2015,2,Salta,98264,30,98294
2015,2,San Juan,51367,6210,57577
2015,2,San Luis,12904,3170,16074
2015,2,Santa Cruz,25384,3790,29174
2015,2,Santa Fe,545739,6490,552229
2015,2,Santiago Del Estero,39375,30,39405
2015,2,Tierra Del Fuego,32960,6190,39150
2015,2,Tucumán,140635,420,141055
2015,1,Buenos Aires,2847076,14766,2861842
2015,1,Capital Federal,1321139,11582,1332721
2015,1,Catamarca,25312,200,25512
2015,1,Chaco,81329,310,81639
2015,1,Chubut,63327,1946,65273
2015,1,Córdoba,596663,2940,599603
2015,1,Corrientes,81488,430,81918
2015,1,Entre Ríos,165839,2310,168149
2015,1,Formosa,26657,430,27087
2015,1,Jujuy,36608,30,36638
2015,1,La Pampa,62155,5420,67575
2015,1,La Rioja,16310,230,16540
2015,1,Mendoza,168355,1805,170160
2015,1,Misiones,85139,70,85209
2015,1,Neuquén,93373,2369,95742
2015,1,Río Negro,96145,1188,97333
2015,1,Salta,96793,180,96973
2015,1,San Juan,51117,7020,58137
2015,1,San Luis,12878,3540,16418
2015,1,Santa Cruz,26217,4240,30457
2015,1,Santa Fe,535640,7970,543610
2015,1,Santiago Del Estero,39244,80,39324
2015,1,Tierra Del Fuego,32726,7300,40026
2015,1,Tucumán,138184,920,139104
2014,4,Buenos Aires,2801178,15229,2816407
2014,4,Capital Federal,1318526,11994,1330520
2014,4,Catamarca,25472,210,25682
2014,4,Chaco,65998,370,66368
2014,4,Chubut,66557,1985,68542
2014,4,Córdoba,590113,3190,593303
2014,4,Corrientes,65656,540,66196
2014,4,Entre Ríos,140567,2460,143027
2014,4,Formosa,26156,510,26666
2014,4,Jujuy,35999,30,36029
2014,4,La Pampa,56813,5670,62483
2014,4,La Rioja,16379,230,16609
2014,4,Mendoza,167766,1848,169614
2014,4,Misiones,77222,70,77292
2014,4,Neuquén,92999,2397,95396
2014,4,Río Negro,95050,121,95171
2014,4,Salta,93921,260,94181
2014,4,San Juan,51390,7290,58680
2014,4,San Luis,12788,3590,16378
2014,4,Santa Cruz,25277,4360,29637
2014,4,Santa Fe,528459,9380,537839
2014,4,Santiago Del Estero,39308,90,39398
2014,4,Tierra Del Fuego,28249,7410,35659
2014,4,Tucumán,137329,950,138279
2014,3,Buenos Aires,2835537,14028,2849565
2014,3,Capital Federal,1307195,1063,1308258
2014,3,Catamarca,24665,210,24875
2014,3,Chaco,63710,360,64070
2014,3,Chubut,67130,2007,69137
2014,3,Córdoba,585231,2000,587231
2014,3,Corrientes,63516,330,63846
2014,3,Entre Ríos,136618,1150,137768
2014,3,Formosa,25873,640,26513
2014,3,Jujuy,33739,20,33759
2014,3,La Pampa,61861,5640,67501
2014,3,La Rioja,15893,230,16123
2014,3,Mendoza,166184,174,166358
2014,3,Misiones,75327,0,75327
2014,3,Neuquén,100099,2268,102367
2014,3,Río Negro,96629,1151,97780
2014,3,Salta,92929,250,93179
2014,3,San Juan,51031,7480,58511
2014,3,San Luis,12683,3630,16313
2014,3,Santa Cruz,25664,4460,30124
2014,3,Santa Fe,520196,6910,527106
2014,3,Santiago Del Estero,37539,90,37629
2014,3,Tierra Del Fuego,28037,7550,35587
2014,3,Tucumán,131978,880,132858
2014,2,Buenos Aires,2750430,14116,2764546
2014,2,Capital Federal,1299502,10713,1310215
2014,2,Catamarca,24660,230,24890
2014,2,Chaco,63243,360,63603
2014,2,Chubut,68503,2016,70519
2014,2,Córdoba,576747,2050,578797
2014,2,Corrientes,62925,330,63255
2014,2,Entre Ríos,135468,1150,136618
2014,2,Formosa,25535,650,26185
2014,2,Jujuy,34359,20,34379
2014,2,La Pampa,55048,5800,60848
2014,2,La Rioja,15889,230,16119
2014,2,Mendoza,165046,1761,166807
2014,2,Misiones,74689,0,74689
2014,2,Neuquén,90053,2235,92288
2014,2,Río Negro,94812,1145,95957
2014,2,Salta,91949,250,92199
2014,2,San Juan,50891,7550,58441
2014,2,San Luis,12691,3640,16331
2014,2,Santa Cruz,26710,4590,31300
2014,2,Santa Fe,511753,6050,517803
2014,2,Santiago Del Estero,38002,90,38092
2014,2,Tierra Del Fuego,27443,7660,35103
2014,2,Tucumán,131981,880,132861
2014,1,Buenos Aires,2725732,14144,2739876
2014,1,Capital Federal,1289204,10714,1299918
2014,1,Catamarca,24209,230,24439
2014,1,Chaco,62520,360,62880
2014,1,Chubut,68205,2016,70221
2014,1,Córdoba,566705,2050,568755
2014,1,Corrientes,62203,330,62533
2014,1,Entre Ríos,134216,1150,135366
2014,1,Formosa,25335,870,26205
2014,1,Jujuy,33825,20,33845
2014,1,La Pampa,53601,5920,59521
2014,1,La Rioja,15688,230,15918
2014,1,Mendoza,164084,1761,165845
2014,1,Misiones,73950,0,73950
2014,1,Neuquén,88077,2303,90380
2014,1,Río Negro,93909,1157,95066
2014,1,Salta,91265,250,91515
2014,1,San Juan,50543,7550,58093
2014,1,San Luis,12193,3640,15833
2014,1,Santa Cruz,26304,4600,30904
2014,1,Santa Fe,506000,6120,512120
2014,1,Santiago Del Estero,37124,90,37214
2014,1,Tierra Del Fuego,27272,7660,34932
2014,1,Tucumán,129944,880,130824
